111111111111111111111111111111111111111111111111111111111111111111111111111111111111111111111111111
10E011000000000011000110001100011000001100000000000001100000000001100011000110001100000110000000001
100011000110000011000110001100011000001100001100000001100011000001100011000110001100000110000110001
10001100011101111100011000110000000000000000110C000001100011101111100011000110000000000000000110C01
100000000111011111000000001100011000001100001111000000000011101111100000000110001100000110000111101
111111111110000000000110000000011000001100001111001111111111000000000011000000001100000110000111101
1111111111100C001111111111111111111011111111110000111111111100C001111111111111111111011111111110001
100C100001100000111111111111111111101111111111000000C1000011000001111111111111111111011111111110001
100110000111111111001100000110011000110000001100000011000011111111100110000011001100011000000110001
1000000001111111110011000001100110001100C000110000000000001111111110011000001100110001100C000110001
111111101110000000000000000000000000110000001100001111110111000000000000000000000000011000000110001
11111110111000001100110000011001100000000000110C001111110111000001100110000011001100000000000110C01
10C011000110000011111111111111111111111111111111100C01100011000001111111111111111111111111111111111
100011000110000011111111111111111111111111111111100001100011000001111111111111111111111111111111111
100000000000000011001100110001100110C011000000000000000000000000011001100110001100110C0110000000001
100011000110000011001100000001100110000000001100000001100011000001100110000000110011000000000110001
111111111111100000000000110000000110001100001100001111111111110000000000011000000011000110000110001
11111111111110111100110011000110000000110000110C001111111111110111100110011000110000000110000110C01
100110000110000011111101111111111111111111111111100011000011000001111110111111111111111111111111111
100000000110000011111101111111111111111111111111100000000011000001111110111111111111111111111111111
100110000110P000110C010000000110001100001100000000001100001100000110C010000000110001100001100000001
100110000000000011000000000001100011000000001100000011000000000001100000000000110001100000000110001
100110000110000011000110000001100000000011001100000011000011000001100011000000110000000001100110001
10011000011000001100011000000000001100001100110C000011000011000001100011000000000001100001100110C01
100000000000000000000000000000000000000000000000000000000000000000000000000000000000000000000000001
100011000000000011000110001100011000001100000000000001100000000001100011000110001100000110000000001
100011000110000011000110001100011000001100001100000001100011000001100011000110001100000110000110001
10001100011101111100011000110000000000000000110C000001100011101111100011000110000000000000000110C01
100000000111011111000000001100011000001100001111000000000011101111100000000110001100000110000111101
111111111110000000000110000000011000001100001111001111111111000000000011000000001100000110000111101
1111111111100C001111111111111111111011111111110000111111111100C001111111111111111111011111111110001
100C100001100000111111111111111111101111111111000000C1000011000001111111111111111111011111111110001
100110000111111111001100000110011000110000001100000011000011111111100110000011001100011000000110001
1000000001111111110011000001100110001100C000110000000000001111111110011000001100110001100C000110001
111111101110000000000000000000000000110000001100001111110111000000000000000000000000011000000110001
11111110111000001100110000011001100000000000110C001111110111000001100110000011001100000000000110C01
10C011000110000011111111111111111111111111111111100C01100011000001111111111111111111111111111111111
100011000110000011111111111111111111111111111111100001100011000001111111111111111111111111111111111
100000000000000011001100110001100110C011000000000000000000000000011001100110001100110C0110000000001
100011000110000011001100000001100110000000001100000001100011000001100110000000110011000000000110001
111111111111100000000000110000000110001100001100001111111111110000000000011000000011000110000110001
11111111111110111100110011000110000000110000110C001111111111110111100110011000110000000110000110C01
100110000110000011111101111111111111111111111111100011000011000001111110111111111111111111111111111
100000000110000011111101111111111111111111111111100000000011000001111110111111111111111111111111111
1001100001100000110C010000000110001100001100000000001100001100000110C010000000110001100001100000001
100110000000000011000000000001100011000000001100000011000000000001100000000000110001100000000110001
100110000110000011000110000001100000000011001100000011000011000001100011000000110000000001100110001
10011000011000001100011000000000001100001100110C000011000011000001100011000000000001100001100110C01
100000000000000000000000000000000000000000000000000000000000000000000000000000000000000000000000001
100000000111011111000000001100011000001100001111000000000011101111100000000110001100000110000111101
111111111110000000000110000000011000001100001111001111111111000000000011000000001100000110000111101
1111111111100C001111111111111111111011111111110000111111111100C001111111111111111111011111111110001
100C100001100000111111111111111111101111111111000000C1000011000001111111111111111111011111111110001
100110000111111111001100000110011000110000001100000011000011111111100110000011001100011000000110001
1000000001111111110011000001100110001100C000110000000000001111111110011000001100110001100C000110001
111111101110000000000000000000000000110000001100001111110111000000000000000000000000011000000110001
11111110111000001100110000011001100000000000110C001111110111000001100110000011001100000000000110C01
10C011000110000011111111111111111111111111111111100C01100011000001111111111111111111111111111111111
100011000110000011111111111111111111111111111111100001100011000001111111111111111111111111111111111
100000000000000011001100110001100110C011000000000000000000000000011001100110001100110C0110000000001
100011000110000011001100000001100110000000001100000001100011000001100110000000110011000000000110001
111111111111100000000000110000000110001100001100001111111111110000000000011000000011000110000110001
11111111111110111100110011000110000000110000110C001111111111110111100110011000110000000110000110C01
100110000110000011111101111111111111111111111111100011000011000001111110111111111111111111111111111
100000000110000011111101111111111111111111111111100000000011000001111110111111111111111111111111111
1001100001100000110C010000000110001100001100000000001100001100000110C010000000110001100001100000001
100110000000000011000000000001100011000000001100000011000000000001100000000000110001100000000110001
100110000110000011000110000001100000000011001100000011000011000001100011000000110000000001100110001
10011000011000001100011000000000001100001100110C000011000011000001100011000000000001100001100110C01
100000000000000000000000000000000000000000000000000000000000000000000000000000000000000000000000001
100000000111011111000000001100011000001100001111000000000011101111100000000110001100000110000111101
111111111110000000000110000000011000001100001111001111111111000000000011000000001100000110000111101
1111111111100C001111111111111111111011111111110000111111111100C001111111111111111111011111111110001
100C100001100000111111111111111111101111111111000000C1000011000001111111111111111111011111111110001
100110000111111111001100000110011000110000001100000011000011111111100110000011001100011000000110001
1000000001111111110011000001100110001100C000110000000000001111111110011000001100110001100C000110001
111111101110000000000000000000000000110000001100001111110111000000000000000000000000011000000110001
11111110111000001100110000011001100000000000110C001111110111000001100110000011001100000000000110C01
10C011000110000011111111111111111111111111111111100C01100011000001111111111111111111111111111111111
100011000110000011111111111111111111111111111111100001100011000001111111111111111111111111111111111
100000000000000011001100110001100110C011000000000000000000000000011001100110001100110C0110000000001
100011000110000011001100000001100110000000001100000001100011000001100110000000110011000000000110001
111111111111100000000000110000000110001100001100001111111111110000000000011000000011000110000110001
11111111111110111100110011000110000000110000110C001111111111110111100110011000110000000110000110C01
100110000110000011111101111111111111111111111111100011000011000001111110111111111111111111111111111
100000000110000011111101111111111111111111111111100000000011000001111110111111111111111111111111111
1001100001100000110C010000000110001100001100000000001100001100000110C010000000110001100001100000001
100110000000000011000000000001100011000000001100000011000000000001100000000000110001100000000110001
100110000110000011000110000001100000000011001100000011000011000001100011000000110000000001100110001
10011000011000001100011000000000001100001100110C000011000011000001100011000000000001100001100110C01
100000000000000000000000000000000000000000000000000000000000000000000000000000000000000000000000001
111111111111111111111111111111111111111111111111111111111111111111111111111111111111111111111111111
