11111111111111111111111111111111111111111111111111
10E01100000000001100011000110001100000110000000001
10M01100011000001100011000110001100000110000110001
10001100011101111100011000110000000000000000110C01
10000000011101111100000000110001100000110000111101
11111111111000000000011000000001100000110000111101
1111111111100C001111111111111111111011111111110001
100C10000110000011111111111111111110111111111100M1
10011000011111111100110000011001100011000000110001
1000000001111111110011000001100110001100C000110001
1111111011100000000000000000000000001100M000110001
11111110111000001100110000011001100000000000110C01
10C01100011000001111110111111111111111111111111111
10001100011000001111110111111111111111111111111111
10M000000000000011001100110001100110C0110000000001
100011000110000011001100000M0110011000000000110001
11111111111110000000000011000000011000110000110M01
11111111111110111100110011000110000000110000110C01
10011000011000001111110111111111111111111111111111
10000000011000001111110111111111111111111111111111
1001100001100000110C010000000110001100001100000001
1001100000000M001100000000000110001100000000110001
10011000011000001100011000000110000000001100110001
1P011000011000001100011000000000001100001100110C01
11111111111111111111111111111111111111111111111111
