11111111111111111111111111111111111111111111111111
10E01100000000001100011000110001100000110000000001
10001100011000001100011000110001100000110000110001
10001100011101111100011000110000000000000000110C01
10000000011101111100000000110001100000110000111101
11111111111000000000011000000001100000110000111101
1111111111100C001111111111111111111011111111110001
100C1000011000001111111111111111111011111111110001
10011000011111111100110000011001100011000000110001
1000000001111111110011000001100110001100C000110001
11111110111000000000000000000000000011000000110001
11111110111000001100110000011001100000000000110C01
10C01100011000001111111111111111111111111111111111
10001100011000001111111111111111111111111111111111
100000000000000011001100110001100110C0110000000001
10001100011000001100110000000110011000000000110001
11111111111110000000000011000000011000110000110001
11111111111110111100110011000110000000110000110C01
10011000011000001111110111111111111111111111111111
10000000011000001111110111111111111111111111111111
100110000110P000110C010000000110001100001100000001
10011000000000001100000000000110001100000000110001
10011000011000001100011000000110000000001100110001
10011000011000001100011000000000001100001100110C01
11111111111111111111111111111111111111111111111111
