11111111111111111111111111111111111111111111111111
10001100000000001100011000110001100000110000000001
10001100011000001100011000110001100000110000110001
10001100011101111100011000110000000000000000110001
10000000011101111100000000110001100000110000111101
11111111111000000000011000000001100000110000111101
11111111111000001111111111111111111011111111110001
10001000011000001111111111111111111011111111110001
10011000011111111100110000011001100011000000110001
10000000011111111100110000011001100011000000110001
11111110111000000000000000000000000011000000110001
11111110111000001100110000011001100000000000110001
10001100011000001111110111111111111111111111111111
10001100011000001111110111111111111111111111111111
10000000000000001100110011000110011000110000000001
10001100011000001100110000000110011000000000110001
11111111111110000000000011000000011000110000110001
11111111111110111100110011000110000000110000110001
10011000011000001111110111111111111111111111111111
10000000011000001111110111111111111111111111111111
10011000C11000001100010000000110001100001100000001
1001100CCCCCCC001100000000000110001100000000110001
1001100001100E001100011000000110000000001100110001
1P011000011000001100011000000000001100001100110001
11111111111111111111111111111111111111111111111111
